%%%%%%%%%%%%%%%%%%%%
%o   %   G    %   o%
% %% % %%  %% % %% %
%       G GG%      %
% % %% %% %%% %% % %
% %    % ooo%.%  % %
% % %% % %% % % %% %
%o%      P    %    %
%%%%%%%%%%%%%%%%%%%%
