%%%%%%%%%%%%%%%%%%%%
%    %        %    %
% %% % %%%%%% % %% %
% %      G       % %
% % %% %%  %% %% % %
%      %G .G%      %
% % %% %%%%%% %% % %
% %              % %
% %% % %%%%%% % %% %
%    %   P    %    %
%%%%%%%%%%%%%%%%%%%%
